333333333333333
344434434334433
334334434334343
334334434434433
333333333333333
343343333323333
343343333323333
343343333323333
34444333332333
333333333333333