             6
      111  111
      1611111
    11111  11
    131    11
  11111   1111
 1121     1111
 1111  11111
      111
      111