 21111111151111
     11      11
     11      11
             11
             11
111  11  151111
131  11
111  11
 11  11
 1111111115111