       5
1151   1
11111  1
15211111  11  1
11111   1   1
1151    1   1
1       5  111
1         1131
1  6      1111