111
121111111   111
111     1111131
111         661
111
111
111    111116
11111111   11
151        11
111        16