       111  111
    111111  611
11  1  111  111
11111   5
11
 1     7
 1     1
111   111  511
12111111111131
111   111  511