  1111
  1311
  111
  1   111111
  1   11  11
 2111111  111
      15    1
      1111  1
      1111111
         111