1114111141111
11        111
11         111
111   111  121
111444131  111
111  4111  1
  1  4444411
  111441444
   11444444
   111  11