        111
   111  111
1  12111111111
1  111      61
1           11
1           11
1       111111
11111   111
 1131   111
  111   111116