111     111111
131  1  121171
111     1111
         111
           11
            1
            1
           11
    11111  11
    15  11161