 111111
 11  111
442  1111
44     111
44      111
4111     117
 131      11111
 111111   15111
  1  11   111
  1  11111111