     11    111
   111111  131
11111151111111
12115  11111
111      111
 1        1
 1        1
 1       11
 11      11
  6      6