            111
  11111111  111
  111  521  111
  111  111
  151  715
  111  111
1111   111  511
15          111
            131
            111