 111        111
 161        151
 111   11111111
 111   131  115
1   1  111    1
5   1  444    1
1  111444441111
   12144444171
   11144444111
   11111