  11
  111
  115     111
   1111   131
      11  111
 11   11
11611111
121   11   111
111   11511111
           111