        11
       111
11  111111
121111  1
1111    1   111
 11     6111131
  1     61  111
  111   11
   111  11
    111111