

      1111  111
1111  1161  131
1151  1111  111
1111  1111  111
1211  1111  111
1111  1111