     1111    7
     115111  1
    1111111  1
11111111  1111
111   1   11
111   1   2
 1    111
 6    131
      111