111    11111111
12111111111  11
111    11    11
            161
            11
111  44441  55
1314444444  111
111444444444111
     4444444111
      1111