            16
  111111   111
 111  11  1611
 131   11111
 111    111
         11
    111  12
11  161  11
11  1111111