           111
 111    6  131
 11111111  111
 111  111   1
 444  511   4
  4   111  444
  1   111  111
1111  15111121
1161  6    111
1111