

      1111111
1111  111  11
111111111  1111
1211       1131
1111        111