     115111
     111111
111  511511111
12111111155115
     115115111
     111111511
111  1111115111
13111151  11156
111  111   1111
111         111