           1111
 11111115111121
 1111       111
 1151
 1111
   1115111111
          11115
111       11111
1311111111111
1111