     111111
     1  111
     1  11111
211111     1111
    111    1131
    111     111
      1  11
      11111
      11111
       111