
        1111
        1111
111     1  1111
121111111   131
111    116  111
111    111  111
 11    1
  111111